0,0,0,0,X,0,0,0,A
0,X,0,X,0,0,X,X,X
0,0,0,0,0,X,0,0,0
0,X,X,0,X,B,0,X,0
0,0,0,X,0,X,0,X,0
0,X,0,X,0,0,0,X,0
0,0,0,0,X,X,X,0,0
0,0,X,X,0,0,0,X,0
0,0,0,0,0,X,0,0,0
